11111111111111111111111111111111
1000000P00001010000010010000C001
11111111100000001111E00000000111
11111111111111111111111111111111
